D53D153D3
97A969692
83AC3C56A
AC6969396
AD383EAC3
C3C68383A
9693AAE86
A96AEC3AB
C6D4556C6

0,0
8,8

NES
